NO ./include/assets/textures/eagle.xpm

WE                    ./include/assets/textures/red.xpm

EA ./include/assets/textures/purplestone.xpm


C 53,41               ,34
F 255,33,27



SO ./include/assets/textures/greystone.xpm

11111111111111111111111111111111111111111111111111111111111111111111111111111111111111111111111111111
111100011111111
111110000011111                11111
111100000001111                1    1
111000000N0111                 1     1
1100000000000011               111111
10000111110010001
110000111001 1101
11100001001   101
111100000001 1001
1111100000001101
1111110001100001
111111111111111
1
1

111111111111111111
1                1 
1                1
1                1
111111111111111111
