NO ./assets/mossy_wall.xpm
SO ./assets/mossy_wall.xpm
EA ./assets/mossy_wall.xpm


WE ./assets/mossy_wall.xpm


C 53,41         ,34
F 45,33,27

111111111111111
111111000111111
111110000011111
11110000000111111
1110000000000000011111
1100011111000000000011
100001   1000101111111
110000111000100011111
11100001000010N0111
1111000000000101111
11111000000001111
111111000000111111
111111111111111

